##############################
#                            #
#      E                     #
#                            #
#                            #
#                            #
#                            #
#                            #
#                            #
#                            #
#                            #
#                            #
#                            #
#                            #
#                 #######    #
#                 #          #
#                       S    #
#                            #
#                            #
##############################