##############################
#           #                #
# E         #                #
#           #                #
#########   #   #####   ######
#           #   #   #   #    #
#           #   # S #   #    #
#           #   #   #   #    #
#   #       #   #   #   #    #
#   #       #   #   #   #    #
#   #   #########   #   #    #
#   #               #   ##   #
#   #                        #
#   #                        #
#   #####   #   #            #
#           #   ##########   #
#           #                #
#           #                #
#           #                #
##############################